1 1 1 1 1 1 1 1 
1 1 1 6 6 1 1 1 
1 1 1 1 1 1 1 1 
0 0 6 1 1 6 0 0 
0 0 0 0 0 0 0 0 
0 0 0 0 0 0 0 0 
0 0 0 0 0 0 0 0 
0 0 0 0 0 0 0 0